.##########......
...########......
#...###..........
#..##.#.####.....
#.##..###..#.....
###........#.....
##...@..#..######
####..###........#
#..#..#....######
#.##.##.#.##.....
#.#......##......
#.#.....##.......
#.#######........