.##########...
...########...
#...###.......
#..##.#.####..
#.##..###..#..
###........#..
##...@..#..###
####..###..#..
#..#..#....#..
#.##.##.#.##..
#.#......##...
#.#.....##....
#.#######.....