f#.......c
.#.#######
.#........
..#.####.#
#.#.#@...#
#.#.######
.c#......c
.#..#####.
.####...#.
......#...