.##########...........
...########........
#...###............
#..##.#.####........
#.##..###..#..........
###........#..........
##...@..#..#########.#
####..###.......p...p#
#..#..#....###########
#.##.##.#.##...........
#.#......##...........
#.#.....##............
#.#######.............
################......