.##############.......
...########....#...###
#...###....###.#...#.#
#..##.#.####.#..#..#.#
#.##..###..#..#.#..#..
###........#..#.#..#.#
##...@..#..####.####.#
####..###.......p...p#
#..#..#....###########
#.##.##.#.##...........
#.#......##...........
#.#.....##............
#.#######.............
################......