f#.......c
.#.#######
.#........
..#.####.#
.#..p.....
f.#.####.#
#.#.#@...#
#.#.######
.c#.p....c
.#..#####.
p####...#.
......#...