f#.......c
.#.#######
.#..p.....
..#.####.#
#.#.#@...#
#.#.######
.c#.p....c
.#..#####.
p####...#.
......#...