.#.......c
.#.#######
p#..c.....
..#.####.#
#.#.#@...#
#.#.######
.c#.c....c
.#..#####.
p####...#.
......#...