.##########.......
...########.......
#...###...........
#..##.#.####......
#.##..###..#......
###........#......
##...@..#..######.
####..###.......p#
#..#..#....######.
#.##.##.#.##......
#.#......##.......
#.#.....##........
#.#######.........
################..