.#.......c
.#.#######
.#........
f.#.####.#
#.#.#@...#
#.#.######
.c#......c
.#..#####.
.####...#.
......#...