.##############....
...########....#...
#...###....###.#...
#..##.#.####.#..#..
#.##..###..#..#.#..
###........#..#.#..
##...@..#..####.###
####..###......p..#
#..#..#....########
#.##.##.#.##.......
#.#......##........
#.#.....##.........
#.#######..........
################...
...................
...................
...................
.##############....
.##############....
.##############....