##...#c#.###.....##c
#..#.p.#.#...###..p.
#.##.###.#.###.#####
#.#..#.....#.......#
#.#.##.###.###.###.#
..#..#...#.....#.#.#
.###.###.#######.#.#
...#...#.#...#...#.#
##.#.###.#.###.#...#
.#.#.#...#.....#####
.#.#.#.#######.#....
...#.#.......#...##.
.#####.#####.######.
.#...#...#.#...#....
.#.#.###.#.###.#.##.
...#.#c#.#.#...#.#..
####.#.#.#.#.###.#p#
.p.#.#.p...#.#...#..
.#.#.#######.#.####.
@#...........#....#f