.#########
...#######
#...###..#
#..##.#.##
#.##..####
###......#
##...@..##
####..####
#..#..#..#
#.##.##.##