.#.......c
.#.#######
p#..p.....
..#.####.#
#.#.#@...#
#.#.######
.c#.p....c
.#..#####.
p#.##...#.
......#...